20000000000000000002
20000000000000000002
20000000000333330002
23500000000111110002
22000000000000000002
22004444500000000002
22000000000000000002
22000000000000000002
22000000000000000002
22333333333333333332
11111111111111111111
