00000000000000000000
00000000000000000000
00000000000000000000
00000000000000000000
00000000000000000033
00000000000000333322
00000033333333222220
00333322221111111000
33221200000000000000
22220222222222222222
11111111111111111111
